6 13
#############
X   #       #
#   #   #   #
#   #   #   #
#       #   E
#############